NO ./textures/wood_hor.png
SO ./textures/wood_ver.png
WE ./textures/brick.png
EA ./textures/grass.png
F 220,100,0
C 225,30,0

11111
10N01
10 01
11111