NO textures/wood_hor.png
SO textures/brick.png
WE textures/wood_ver.png
EA textures/grass.png
F 220,100,0
C 225,30,0



111111111111
100001000001
100000000001
10N001000011
100000000001
100000000001
111111111111
